P P P P P P P P P P P P P P P P P P P P P P P P P P P P P P P
P V V V V V V V V V V V V V V V V V V V V V V V V V V V V V P
P V V V V V V V W V V V V V V V V V V V V V V V V V O V V V P
P P P P P P P P P P P P P P P P P E P P P P P P P P P P P P P
P V V V V V V V V V V V V V V V V E V V V V V V V V V V V V P
P V V V V K V V V V V V V V V V V E V V V V V V V V V V V V P
P V V V P P P P P P P P P P P P P E V V V V V V V V V V V V P
P V V V V V V V V V V V V V V V V E V V V V V V V V V O V V P
P V V V V V V V V V V M V V V V V E V V V F V V V V V V V V P
P V V E P P P P P P P P P P P P P P P P P P P P A P P P P P P
P V V E V V V V V V V V V V V V V V V V V V V V V V V V V V P
P O V E V V V V V V V V V V V V V V V V V V V V V V V V V V P
P P P P P P P P P P P P P P P P E V V V V V V V V V V V V V P
P V V V V V V V V V V V V V V V E V V V V V V V V V V V V V P
P V V V M V V V V V V V V V V V E V V V V V V F V V V V V V P
P P P P P P P P A P P P P P P P P P P P P P P P P P P P E V P
P V V V V V V V V V V V V V V V V V V V V V V V V V V V E V P
P V V V V V V V V V V V V V V V V V V V V V V V V V V V E V P
P V V V V V V V V V V M V V V V V V V V V F V V V V O V E V P
P V V V V V V V V V V P P E P P P P P P P A P P P P P P P V P
P V V V V V V V V V V V V E V V V V V V V V V V V V V V V V P
P V V V V V V V V V V V V E V V V V V V V O V V V V O V V V P
P V J V V V O V V V V V V E V V V V V V V V V V V V V V V V P
P P P P P P P P P P P P P P P P P P P P P P P P P P P P P P P
