P P P P P P P P P P P P P P P P P P P P P P P P P P P P P P P
P V V V V V V V V V V V V V V V V V V V V V V V V V V V V V P
P V V V V V V V V V V V V V W V V V V V V V V V K V V V V V P
P P P P P P P P E P A P P P P P P V P P P P P P P P P P P P P
P O V V V V V V E V V V V V V V V V V V V V V V V V V V V V P
P V V V V V V V E V V V V V V V V V V V V V V V V V V V V V P
P V V V P P P P P P P P P P P P P E V V V V V V V V V V V V P
P V V V V V V V V V V V V V V V V E V V V V V V V V V V V V P
P V V O V V V V V V V V V V V V V E V V V V V V V V V V O V P
P V V V P P P V V V V V V V P P P P P V V V V V V V V P A P P
P V V V V V V V V V V V V V V V V V V V V V V V V V V V V V P
P V V V V V V P P P P P V V V V V V V V V V P P P V V V V V P
P V V V V V V V V V V V V P P P E P P P V V V V V V V V V V P
P V V O V V V V V V V V V V V V E V V V V V V V V V V V V O P
P V V V V V M V V V V V V V V V E V V V V V V F V V V V V V P
P P P E P P P P P A P P P P P P P P P P P P P P P P P A V V P
P V V E V V V V V V V V V V V V V V V V V V V V V V V V V V P
P V V E V V V V V V V V V V V V V V V V V V V V V V V V V V P
P V V E V V V V V V V F V V V V V V V V V V V V V V V V V V P
P P P P P P P P P P P P A P P P P P P E V V V V V V V V V V P
P V V V V V V V V V V V V V V V V V V E V V V V V V V V V V P
P V V V V V V V V V V V V V V V V V V E V V V V V V V V O V P
P V J V V V V V V M V V V V V V V V V E V V V V V F V V V V P
P P P P P P P P P P P P P P P P P P P P P P P P P P P P P P P
